NO ./assets/r.xpm
SO ./assets/g.xpm
WE ./assets/b.xpm
EA ./assets/y.xpm

F 155,202,243
C 208,171,147

        1111111111111111111111111
        1000000000110000000000001
        1011000001110000000000001
        1001000000000000000000001
111111111011000001110000000000001
100000000011000001110111111111111
11110111111111011100000010001
11110111111111011101010010001111
11000000110101011100000010001
1000000000000000110000001000111
10000000000000001101010010001
11000001110101011111011110N01111
11110111 1110101 101111010001
11111111 1111111 11111111111111
