NO ./assets/r.xpm
SO ./assets/g.xpm
WE ./assets/b.xpm
EA ./assets/y.xpm

F 155,202,243
C 208,171,147

        1111111111111111111111111
        1000000000110000000000001
        1011000001110000000000001
        1001000000000000000000001
111111111011000001110000000000001
100000000011000001110111111111111
111101111111110111000000000000000010001
1111011111111101110101001000000000001111
1100000011010101110000001000000000000001
1000000000000000110000001000000000000111
1000000000000000110101001000000000000001
11000001110101011111011110N0000000001111
11110111 1110101 10111101000000000001
11111111 1111111 11111111111111111111
